a	a
ai	a i
am	a m
an	a n
anh	a nh
ba	b a
ban	b a n
bao	b a o
ben	b e n
bi	b i
bia	b i a
binh	b i nh
biên	b i ê n
biến	b i ế n
biết	b i ế t
biện	b i ệ n
biệt	b i ệ t
bu	b u
buổi	b u ổ i
by	b y
bà	b à
bài	b à i
bàn	b à n
bánh	b á nh
báo	b á o
báp	b á p
bát	b á t
bé	b é
bê	b ê
bên	b ê n
bình	b ì nh
bò	b ò
bói	b ó i
bóng	b ó ng
bô	b ô
bú	b ú
bước	b ư ớ c
bạc	b ạ c
bại	b ạ i
bạo	b ạ o
bản	b ả n
bảo	b ả o
bảy	b ả y
bất	b ấ t
bầu	b ầ u
bẩn	b ẩ n
bật	b ậ t
bắt	b ắ t
bằng	b ằ ng
bến	b ế n
bếp	b ế p
bể	b ể
bệ	b ệ
bệnh	b ệ nh
bị	b ị
bọn	b ọ n
bỏ	b ỏ
bố	b ố
bốn	b ố n
bộ	b ộ
bội	b ộ i
bờ	b ờ
bụi	b ụ i
bức	b ứ c
bữa	b ữ a
ca	c a
cai	c a i
can	c a n
canh	c a nh
cao	c a o
cha	ch a
chan	ch a n
che	ch e
chem	ch e m
chia	ch i a
chim	ch i m
chinh	ch i nh
chiên	ch i ê n
chiến	ch i ế n
chiếu	ch i ế u
cho	ch o
chu	ch u
chung	ch u ng
chuyển	ch u y ể n
chuyện	ch u y ệ n
chuẩn	ch u ẩ n
chuộc	ch u ộ c
chào	ch à o
chân	ch â n
châu	ch â u
chè	ch è
chén	ch é n
chí	ch í
chính	ch í nh
chúa	ch ú a
chúc	ch ú c
chúng	ch ú ng
chăm	ch ă m
chưa	ch ư a
chương	ch ư ơ ng
chạm	ch ạ m
chạy	ch ạ y
chảy	ch ả y
chấp	ch ấ p
chất	ch ấ t
chấu	ch ấ u
chật	ch ậ t
chắc	ch ắ c
chẳng	ch ẳ ng
chết	ch ế t
chỉ	ch ỉ
chị	ch ị
chịu	ch ị u
chốc	ch ố c
chối	ch ố i
chống	ch ố ng
chớp	ch ớ p
chờ	ch ờ
chở	ch ở
chủ	ch ủ
chứ	ch ứ
chức	ch ứ c
chứng	ch ứ ng
chừng	ch ừ ng
chữa	ch ữ a
con	c o n
cung	c u ng
cuối	c u ố i
cuốn	c u ố n
cuộc	c u ộ c
cuộn	c u ộ n
cà	c à
càng	c à ng
cá	c á
các	c á c
cách	c á ch
cái	c á i
cám	c á m
cát	c á t
cân	c â n
cãi	c ã i
còn	c ò n
có	c ó
cô	c ô
công	c ô ng
cùng	c ù ng
cúi	c ú i
căn	c ă n
căng	c ă ng
cũng	c ũ ng
cơ	c ơ
cơn	c ơ n
cư	c ư
cưu	c ư u
cưới	c ư ớ i
cưỡi	c ư ỡ i
cạn	c ạ n
cả	c ả
cải	c ả i
cảm	c ả m
cản	c ả n
cầu	c ầ u
cập	c ậ p
cắm	c ắ m
cắp	c ắ p
cốp	c ố p
cổng	c ổ ng
cột	c ộ t
của	c ủ a
củi	c ủ i
cứ	c ứ
cứu	c ứ u
cửa	c ử a
danh	d a nh
dinh	d i nh
diệt	d i ệ t
do	d o
dài	d à i
dành	d à nh
dám	d á m
dâm	d â m
dân	d â n
dâng	d â ng
dâu	d â u
dây	d â y
dép	d é p
dê	d ê
dòng	d ò ng
dõi	d õ i
dù	d ù
dùng	d ù ng
dũng	d ũ ng
dại	d ạ i
dạy	d ạ y
dấu	d ấ u
dầu	d ầ u
dẫn	d ẫ n
dẫu	d ẫ u
dậy	d ậ y
dắt	d ắ t
dặn	d ặ n
dẹp	d ẹ p
dọc	d ọ c
dọn	d ọ n
dối	d ố i
dồn	d ồ n
dỗ	d ỗ
dội	d ộ i
dừng	d ừ ng
dựng	d ự ng
e	e
em	e m
ga	g a
gam	g a m
ghen	gh e n
ghi	gh i
ghét	gh é t
ghê	gh ê
gia	gi a
giam	gi a m
gian	gi a n
giao	gi a o
gieo	gi e o
giu	gi u
giàu	gi à u
giày	gi à y
giám	gi á m
giáo	gi á o
giép	gi é p
giê	gi ê
gióp	gi ó p
giô	gi ô
giúp	gi ú p
giăng	gi ă ng
giường	gi ư ờ ng
giả	gi ả
giải	gi ả i
giảng	gi ả ng
giấc	gi ấ c
giận	gi ậ n
giếng	gi ế ng
giết	gi ế t
giốc	gi ố c
giới	gi ớ i
giờ	gi ờ
giữ	gi ữ
giữa	gi ữ a
gác	g á c
gãy	g ã y
gì	g ì
góc	g ó c
gươm	g ư ơ m
gạt	g ạ t
gấu	g ấ u
gần	g ầ n
gặp	g ặ p
gặt	g ặ t
gọi	g ọ i
gốm	g ố m
gỗ	g ỗ
gửi	g ử i
ha	h a
hai	h a i
ham	h a m
hay	h a y
hi	h i
hiền	h i ề n
hiểm	h i ể m
hiểu	h i ể u
hiện	h i ệ n
hiệu	h i ệ u
hoàn	h o à n
hoặc	h o ặ c
hu	h u
hum	h u m
hung	h u ng
huệ	h u ệ
hành	h à nh
hào	h à o
hát	h á t
hãi	h ã i
hãnh	h ã nh
hãy	h ã y
hê	h ê
hình	h ì nh
hòa	h ò a
hòm	h ò m
hô	h ô
hôm	h ô m
hơn	h ơ n
hương	h ư ơ ng
hướng	h ư ớ ng
hưởng	h ư ở ng
hạ	h ạ
hại	h ạ i
hạng	h ạ ng
hải	h ả i
hắn	h ắ n
hằng	h ằ ng
hết	h ế t
hễ	h ễ
họ	h ọ
họa	h ọ a
học	h ọ c
hỏi	h ỏ i
hồi	h ồ i
hồng	h ồ ng
hổ	h ổ
hộ	h ộ
hội	h ộ i
hợp	h ợ p
hủi	h ủ i
hủy	h ủ y
hứa	h ứ a
hữu	h ữ u
im	i m
in	i n
keo	k e o
khi	kh i
khinh	kh i nh
khiêm	kh i ê m
khiêng	kh i ê ng
khiếm	kh i ế m
khiết	kh i ế t
khiển	kh i ể n
khoa	kh o a
khoan	kh o a n
khoen	kh o e n
khu	kh u
khui	kh u i
khuyên	kh u y ê n
khác	kh á c
khí	kh í
khó	kh ó
khóc	kh ó c
khói	kh ó i
khôn	kh ô n
không	kh ô ng
khăn	kh ă n
khước	kh ư ớ c
khấn	kh ấ n
khỏi	kh ỏ i
khốn	kh ố n
khổ	kh ổ
khởi	kh ở i
kia	k i a
kim	k i m
kinh	k i nh
kiêu	k i ê u
kiến	k i ế n
kéo	k é o
kê	k ê
kêu	k ê u
kính	k í nh
ký	k ý
kẻ	k ẻ
kẻo	k ẻ o
kế	k ế
kể	k ể
kỷ	k ỷ
la	l a
lao	l a o
lem	l e m
li	l i
linh	l i nh
liu	l i u
liền	l i ề n
liệm	l i ệ m
liệt	l i ệ t
liệu	l i ệ u
lo	l o
loan	l o a n
loài	l o à i
loại	l o ạ i
loạn	l o ạ n
lu	l u
luôn	l u ô n
luận	l u ậ n
luật	l u ậ t
là	l à
làm	l à m
lành	l à nh
lác	l á c
lát	l á t
lâu	l â u
lãnh	l ã nh
lão	l ã o
léc	l é c
lép	l é p
lê	l ê
lên	l ê n
lìa	l ì a
lình	l ì nh
líp	l í p
lít	l í t
lò	l ò
lòng	l ò ng
lô	l ô
lôn	l ô n
lúa	l ú a
lúc	l ú c
lý	l ý
lũng	l ũ ng
lơ	l ơ
lưng	l ư ng
lưu	l ư u
lương	l ư ơ ng
lưỡi	l ư ỡ i
lạ	l ạ
lạc	l ạ c
lại	l ạ i
lạy	l ạ y
lấy	l ấ y
lầm	l ầ m
lần	l ầ n
lập	l ậ p
lẽ	l ẽ
lễ	l ễ
lệ	l ệ
lệnh	l ệ nh
lỗi	l ỗ i
lộn	l ộ n
lớn	l ớ n
lời	l ờ i
lụt	l ụ t
lừa	l ừ a
lửa	l ử a
lực	l ự c
ma	m a
mai	m a i
man	m a n
mang	m a ng
men	m e n
mi	m i
mim	m i m
min	m i n
minh	m i nh
miền	m i ề n
miệng	m i ệ ng
mu	m u
muôn	m u ô n
muốn	m u ố n
my	m y
mà	m à
màn	m à n
mách	m á ch
mây	m â y
mã	m ã
mãi	m ã i
mê	m ê
mình	m ì nh
mích	m í ch
móc	m ó c
món	m ó n
mô	m ô
môi	m ô i
môn	m ô n
mùa	m ù a
mũi	m ũ i
mưa	m ư a
mưu	m ư u
mươi	m ư ơ i
mười	m ư ờ i
mạnh	m ạ nh
mạo	m ạ o
mật	m ậ t
mắc	m ắ c
mắt	m ắ t
mặt	m ặ t
mẹ	m ẹ
mẽ	m ẽ
mệt	m ệ t
mọi	m ọ i
mỏi	m ỏ i
mồi	m ồ i
mỗi	m ỗ i
mộ	m ộ
mộng	m ộ ng
một	m ộ t
mới	m ớ i
mời	m ờ i
mở	m ở
mỡ	m ỡ
mừng	m ừ ng
na	n a
nay	n a y
ngang	ng a ng
ngay	ng a y
nghe	ngh e
nghiền	ngh i ề n
nghiệp	ngh i ệ p
nghèo	ngh è o
nghìn	ngh ì n
nghĩ	ngh ĩ
nghĩa	ngh ĩ a
ngoa	ng o a
ngoan	ng o a n
ngoài	ng o à i
ngoại	ng o ạ i
nguy	ng u y
nguyên	ng u y ê n
nguyền	ng u y ề n
nguyện	ng u y ệ n
nguyệt	ng u y ệ t
nguồn	ng u ồ n
ngài	ng à i
ngàn	ng à n
ngày	ng à y
ngã	ng ã
ngóng	ng ó ng
ngăn	ng ă n
ngươi	ng ư ơ i
người	ng ư ờ i
ngạc	ng ạ c
ngạch	ng ạ ch
ngậm	ng ậ m
ngập	ng ậ p
ngọn	ng ọ n
ngọt	ng ọ t
ngồi	ng ồ i
ngựa	ng ự a
nhau	nh a u
nhiên	nh i ê n
nhiều	nh i ề u
nhà	nh à
nhái	nh á i
nháp	nh á p
nhân	nh â n
nhìn	nh ì n
nhóm	nh ó m
nhô	nh ô
nhơ	nh ơ
như	nh ư
nhưng	nh ư ng
nhường	nh ư ờ ng
nhượng	nh ư ợ ng
nhả	nh ả
nhấm	nh ấ m
nhất	nh ấ t
nhẫn	nh ẫ n
nhận	nh ậ n
nhắc	nh ắ c
nhặt	nh ặ t
nhịn	nh ị n
nhỏ	nh ỏ
nhờ	nh ờ
nhở	nh ở
những	nh ữ ng
ni	n i
niêu	n i ê u
nàng	n à ng
nào	n à o
này	n à y
nát	n á t
nép	n é p
nê	n ê
nên	n ê n
nó	n ó
nóc	n ó c
nói	n ó i
nô	n ô
nôm	n ô m
nôn	n ô n
núi	n ú i
năm	n ă m
năng	n ă ng
nơi	n ơ i
nước	n ư ớ c
nại	n ạ i
nấy	n ấ y
nắm	n ắ m
nằm	n ằ m
nặng	n ặ ng
nẻo	n ẻ o
nếu	n ế u
nối	n ố i
nồi	n ồ i
nổ	n ổ
nổi	n ổ i
nộ	n ộ
nợ	n ợ
nửa	n ử a
nữ	n ữ
nữa	n ữ a
ong	o ng
pha	ph a
phao	ph a o
phi	ph i
phong	ph o ng
phàm	ph à m
phá	ph á
phái	ph á i
phán	ph á n
pháp	ph á p
phát	ph á t
phân	ph â n
phê	ph ê
phên	ph ê n
phía	ph í a
phòng	ph ò ng
phô	ph ô
phù	ph ù
phút	ph ú t
phương	ph ư ơ ng
phước	ph ư ớ c
phạm	ph ạ m
phạt	ph ạ t
phải	ph ả i
phản	ph ả n
phần	ph ầ n
phẫn	ph ẫ n
phố	ph ố
phụ	ph ụ
phục	ph ụ c
qua	qu a
quan	qu a n
quanh	qu a nh
quay	qu a y
quy	qu y
quyến	qu y ế n
quyết	qu y ế t
quá	qu á
quát	qu á t
quân	qu â n
què	qu è
quý	qu ý
quăng	qu ă ng
quặt	qu ặ t
quốc	qu ố c
quỳ	qu ỳ
quỷ	qu ỷ
ra	r a
ram	r a m
ri	r i
rim	r i m
riêng	r i ê ng
ru	r u
run	r u n
rung	r u ng
ruồng	r u ồ ng
rá	r á
rác	r á c
rách	r á ch
rê	r ê
rình	r ì nh
rít	r í t
rôn	r ô n
rõ	r õ
rút	r ú t
răn	r ă n
rũ	r ũ
rơ	r ơ
rơi	r ơ i
rượu	r ư ợ u
rẩy	r ẩ y
rằng	r ằ ng
rếp	r ế p
rốt	r ố t
rồi	r ồ i
rộng	r ộ ng
rời	r ờ i
rỡ	r ỡ
rủa	r ủ a
rửa	r ử a
rực	r ự c
sa	s a
sai	s a i
sam	s a m
sang	s a ng
sao	s a o
sau	s a u
se	s e
si	s i
sim	s i m
sinh	s i nh
suông	s u ô ng
suối	s u ố i
sàng	s à ng
sách	s á ch
sáng	s á ng
sát	s á t
sáu	s á u
sâu	s â u
sép	s é p
sê	s ê
sóc	s ó c
sôn	s ô n
sông	s ô ng
săn	s ă n
sĩ	s ĩ
sơ	s ơ
sư	s ư
sưởi	s ư ở i
sạch	s ạ ch
sản	s ả n
sấm	s ấ m
sắp	s ắ p
sắt	s ắ t
sẵn	s ẵ n
sẻ	s ẻ
sẽ	s ẽ
số	s ố
sống	s ố ng
sớ	s ớ
sợ	s ợ
sủa	s ủ a
sứ	s ứ
sức	s ứ c
sửa	s ử a
sữa	s ữ a
sự	s ự
ta	t a
tai	t a i
tam	t a m
tan	t a n
tay	t a y
tem	t e m
tha	th a
thai	th a i
thanh	th a nh
thay	th a y
theo	th e o
thim	th i m
thoát	th o á t
thu	th u
thung	th u ng
thuyết	th u y ế t
thuẫn	th u ẫ n
thuốc	th u ố c
thuộc	th u ộ c
thuở	th u ở
thà	th à
thành	th à nh
thách	th á ch
thái	th á i
tháng	th á ng
thánh	th á nh
tháo	th á o
tháp	th á p
thân	th â n
thê	th ê
thêm	th ê m
thì	th ì
thình	th ì nh
thích	th í ch
thù	th ù
thú	th ú
thăm	th ă m
thơm	th ơ m
thư	th ư
thưa	th ư a
thương	th ư ơ ng
thường	th ư ờ ng
thượng	th ư ợ ng
thảm	th ả m
thất	th ấ t
thấy	th ấ y
thần	th ầ n
thầy	th ầ y
thật	th ậ t
thắng	th ắ ng
thẳng	th ẳ ng
thẹn	th ẹ n
thế	th ế
thể	th ể
thị	th ị
thỏa	th ỏ a
thống	th ố ng
thổ	th ổ
thờ	th ờ
thời	th ờ i
thủng	th ủ ng
thứ	th ứ
thức	th ứ c
thừa	th ừ a
thừng	th ừ ng
thử	th ử
thực	th ự c
ti	t i
tin	t i n
tinh	t i nh
tiên	t i ê n
tiêu	t i ê u
tiến	t i ế n
tiếng	t i ế ng
tiếp	t i ế p
tiền	t i ề n
tiệc	t i ệ c
toàn	t o à n
trai	tr a i
trang	tr a ng
tranh	tr a nh
tri	tr i
triều	tr i ề u
triệu	tr i ệ u
trong	tr o ng
trung	tr u ng
truyền	tr u y ề n
tràn	tr à n
trá	tr á
trách	tr á ch
trái	tr á i
trán	tr á n
tránh	tr á nh
trên	tr ê n
trình	tr ì nh
trói	tr ó i
trô	tr ô
trông	tr ô ng
trú	tr ú
trúng	tr ú ng
trăm	tr ă m
trưa	tr ư a
trước	tr ư ớ c
trường	tr ư ờ ng
trưởng	tr ư ở ng
trại	tr ạ i
trấn	tr ấ n
trần	tr ầ n
trị	tr ị
trọn	tr ọ n
trộm	tr ộ m
trời	tr ờ i
trở	tr ở
trợ	tr ợ
trụ	tr ụ
trục	tr ụ c
trừ	tr ừ
tu	t u
tung	t u ng
tuyết	t u y ế t
tuôn	t u ô n
tuổi	t u ổ i
tà	t à
tài	t à i
tàn	t à n
tàu	t à u
tác	t á c
tám	t á m
táng	t á ng
tâm	t â m
tây	t â y
té	t é
tê	t ê
tên	t ê n
tìm	t ì m
tình	t ì nh
tín	t í n
tính	t í nh
tòa	t ò a
tóp	t ó p
tôi	t ô i
tùng	t ù ng
túi	t ú i
tương	t ư ơ ng
tướng	t ư ớ ng
tường	t ư ờ ng
tạ	t ạ
tại	t ạ i
tạm	t ạ m
tảng	t ả ng
tấm	t ấ m
tấn	t ấ n
tất	t ấ t
tầng	t ầ ng
tẩy	t ẩ y
tận	t ậ n
tập	t ậ p
tắc	t ắ c
tắm	t ắ m
tế	t ế
tối	t ố i
tốt	t ố t
tồn	t ồ n
tổ	t ổ
tổng	t ổ ng
tộc	t ộ c
tội	t ộ i
tớ	t ớ
tới	t ớ i
tởm	t ở m
tục	t ụ c
từ	t ừ
từng	t ừ ng
tử	t ử
tự	t ự
u	u
um	u m
uế	u ế
uống	u ố ng
viếng	v i ế ng
viết	v i ế t
việc	v i ệ c
vua	v u a
vui	v u i
và	v à
vài	v à i
vàng	v à ng
vào	v à o
vách	v á ch
vâng	v â ng
vì	v ì
ví	v í
vít	v í t
vó	v ó
vô	v ô
võ	v õ
vùng	v ù ng
văn	v ă n
vũ	v ũ
vương	v ư ơ ng
vượt	v ư ợ t
vạch	v ạ ch
vải	v ả i
vấp	v ấ p
vẫn	v ẫ n
vật	v ậ t
vậy	v ậ y
vắng	v ắ ng
vết	v ế t
về	v ề
vị	v ị
vồ	v ồ
vội	v ộ i
với	v ớ i
vợ	v ợ
vụ	v ụ
vừa	v ừ a
xa	x a
xe	x e
xin	x i n
xong	x o ng
xoáy	x o á y
xu	x u
xung	x u ng
xuân	x u â n
xuất	x u ấ t
xuống	x u ố ng
xác	x á c
xát	x á t
xây	x â y
xét	x é t
xê	x ê
xót	x ó t
xô	x ô
xúc	x ú c
xơ	x ơ
xảy	x ả y
xấu	x ấ u
xếp	x ế p
xứ	x ứ
xức	x ứ c
xứng	x ứ ng
xử	x ử
yên	y ê n
yêu	y ê u
yết	y ế t
yếu	y ế u
ác	á c
ách	á ch
án	á n
ánh	á nh
áp	á p
át	á t
âm	â m
ân	â n
ép	é p
ê	ê
ên	ê n
ít	í t
ô	ô
ôi	ô i
ôn	ô n
ông	ô ng
ý	ý
ăn	ă n
đa	đ a
đam	đ a m
đan	đ a n
đang	đ a ng
đao	đ a o
đau	đ a u
đem	đ e m
đeo	đ e o
đi	đ i
điêu	đ i ê u
điềm	đ i ề m
điều	đ i ề u
điệp	đ i ệ p
đo	đ o
đoán	đ o á n
đuổi	đ u ổ i
đàn	đ à n
đá	đ á
đám	đ á m
đáng	đ á ng
đánh	đ á nh
đáp	đ á p
đát	đ á t
đâm	đ â m
đâu	đ â u
đây	đ â y
đã	đ ã
đãi	đ ã i
đèn	đ è n
đê	đ ê
đêm	đ ê m
đình	đ ì nh
đòn	đ ò n
đó	đ ó
đói	đ ó i
đón	đ ó n
đô	đ ô
đôi	đ ô i
đôm	đ ô m
đông	đ ô ng
đùa	đ ù a
đưa	đ ư a
đường	đ ư ờ ng
được	đ ư ợ c
đại	đ ạ i
đảm	đ ả m
đảo	đ ả o
đất	đ ấ t
đấu	đ ấ u
đầu	đ ầ u
đầy	đ ầ y
đập	đ ậ p
đắng	đ ắ ng
đặc	đ ặ c
đặt	đ ặ t
đẹp	đ ẹ p
đế	đ ế
đếm	đ ế m
đến	đ ế n
đề	đ ề
đền	đ ề n
đều	đ ề u
để	đ ể
đệ	đ ệ
đệm	đ ệ m
địa	đ ị a
định	đ ị nh
đối	đ ố i
đống	đ ố ng
đốt	đ ố t
đồ	đ ồ
đồng	đ ồ ng
đổ	đ ổ
đổi	đ ổ i
độc	đ ộ c
động	đ ộ ng
đời	đ ờ i
đỡ	đ ỡ
đợi	đ ợ i
đủ	đ ủ
đứa	đ ứ a
đức	đ ứ c
đứng	đ ứ ng
đừng	đ ừ ng
đực	đ ự c
đựng	đ ự ng
ơi	ơ i
ước	ư ớ c
ạt	ạ t
ấn	ấ n
ấy	ấ y
ếch	ế ch
ốm	ố m
ốt	ố t
ổn	ổ n
ở	ở
